#.##########.#####
#..........#....##
##.##..###.#....##
##....#..#.#.#####
#.###....#.#.....#
#.....####.#####.#
#######....#.....#
#.......##....####
#######.##########