#.#########.#
#.#...#.....#
#...#.#.#####
#####.#.....#
##....#.....#
#..####.#.###
#.......#...#
###.###.#####